1,강호민,85,90,95,270,90.0
2,김광호,80,70,60,210,70.0
3,김민식,75,85,80,240,80.0
4,김동숙,80,70,90,240,80.0
5,김완섭,90,80,90,260,86.7
6,김성주,85,95,70,250,83.3
7,박태주,90,80,90,260,86.7
8,송문선,80,70,85,235,78.3
9,오석호,80,80,80,240,80.0
10,이기훈,85,70,90,245,81.7
11,이성재,70,75,85,230,76.7
12,이민경,80,85,85,250,83.3
13,이원민,85,85,70,240,80.0
14,이주경,70,70,80,220,73.3
15,장경준,80,80,90,250,83.3
16,정민호,70,60,80,210,70.0
17,지동숙,80,90,70,240,80.0
18,최경숙,85,75,80,240,80.0
19,최애경,70,80,90,240,80.0
20,황진명,80,90,80,250,83.3